Friends|date;wedding;friend;meet;apartment;occupation;privation;baby;play;work;girl;party;love;gang;visit;together;guy;life;call;parent;
How I Met Your Mother|gang;wedding;meet;lily;date;relationship;woman;occupation;support;apartment;plan;girl;marshall;run;privation;together;departure;narrative;travel;party;
Breaking Bad|family;business;deal;struggle;action;trouble;plan;lead;relationship;confront;occupation;life;hazard;suffer;operation;drug;confrontation;secret;meet;support;
Narcos|drug;government;family;plan;run;danger;deal;hunt;meet;trust;foreman;dangerous;occupation;brother;colombian;connect;godhead;terrorist;operation;associate;
Sense8|life;struggle;connection;confront;danger;earth;trouble;survival;meet;luck;disturb;contact;confrontation;experience;fight;determination;mystery;destiny;journey;stranger;
Stranger Things|male_child;force;strange;girl;young;alliance;truth;improbable;disappearance;lab;ally;search;town;uncover;questioning;sudden;shady;development;violent;disappear;
NCIS: Los Angeles|team;clandestine;murder;investigate;agent;case;search;terrorist;lead;uncover;locate;steal;suspect;security;probe;evidence;articulation;death;mission;path;
NCIS: New Orleans|team;murder;case;investigate;petit_larceny;military_officer;lead;spouse;operation;agent;target;locate;steal;clandestine;home;dead;work;die;evidence;connect;
CSI: Cyber|team;investigate;hacker;chop;murder;woman;lead;home;kill;death;hack;web_site;man;criminal;killer;system;path;case;abduction;work;
CSI: NY|team;death;murder;investigate;body;dead;man;woman;lead;young;crime;case;time;victim;evidence;life;run;probe;killer;suspect;
Grey's Anatomy|patient;hospital;doctor;surgery;life;relationship;work;case;checkup;decision;intern;resident;mother;woman;deal;play;friend;family;visit;death;
ER|patient;dainty;woman;mother;father;hospital;occupation;work;life;care;man;death;girl;family;doctor;child;injure;save;visit;young;
Marvel's Daredevil|battle;firm;force;vigilante;crime;law;save;case;control;future;male_child;struggle;truth;enemy;night;client;past;fight;garbage;startle;
Marvel's Iron Fist|dead;struggle;old_age;fight;meet;cryptic;conflict;battle;search;play;proposal;family;game;skill;weapon;choice;attach;sister;personal;unconventional;
Castle|murder;case;probe;killer;investigate;death;victim;team;lead;universe;dead;work;uncover;woman;man;life;young;secret;body;suspect;
The Mentalist|murder;team;investigate;suspect;case;killer;death;lead;probe;man;work;young;kill;uncover;crime;serial;psychic;leader;search;clandestine;
Pretty Little Liars|girl;secret;friend;lead;life;deal;support;family;mother;past;game;surprise;plan;night;relationship;question;search;departure;time;uncover;
Gossip Girl|relationship;father;plan;family;secret;play;friend;party;mother;meet;book;school;uncover;life;support;feelings;past;evening;problem;together;
The Middle|school;family;child;occupation;friend;time;parent;college;plan;life;privation;house;trip;class;meet;run;party;play;support;home;
Malcolm in the Middle|male_child;family;school;home;girl;occupation;house;class;parent;support;play;visit;run;drive;meet;child;plan;time;departure;friend;
The Walking Dead|group;survivor;battle;search;life;supply;decision;force;prison;survive;trouble;menace;universe;community;mission;lead;plan;run;struggle;brush;
Fear the Walking Dead|family;search;struggle;past;together;support;uncover;universe;menace;home;decision;confront;meet;world;fictional_character;cryptic;dark;agitation;contend;acquaintance;
Game of Thrones|plan;meet;run;landing;king;battle;fight;control;gift;ally;family;old;capture;death;struggle;articulation;raise;alliance;kingdom;army;
Vikings|battle;son;plan;god;meet;army;fleet;warrior;king;force;leader;alliance;brother;lead;power;hazard;win;land;support;family;
The Handmaid's Tale|life;remember;survive;survival;recall;surprise;disclosure;play;memory;dangerous;decision;visit;struggle;family;woman;baby;visiting;past;secret;supply;
Westworld|search;host;play;universe;meet;pursuit;world;park;uncover;brush;narrative;hunt;behavior;boldface;question;repeat;programmer;homo;town;appearance;
Mr. Robot|hack;operation;play;plan;hacker;lead;cryptic;mystery;run;game;protect;automaton;call;desire;belief;group;destroy;enroll;privation;firm;
The Flash|team;battle;power;speed;support;attack;save;run;death;friend;dangerous;time;old;life;meet;privation;force;uncover;city;villain;
Gotham|plan;city;meet;uncover;friend;coerce;control;confront;murder;search;battle;lead;past;target;power;carry;secret;father;investigate;killer;
Under the Dome|town;resident;dome;cryptic;uncover;force;life;run;secret;menace;trap;coerce;death;tunnel;plan;storm;universe;hazard;leader;infect;
The 100|plan;life;survival;coerce;save;earth;force;survive;lead;battle;universe;struggle;charge;hope;deal;peace;hazard;dangerous;menace;confront;
The Blacklist|force;undertaking;dangerous;target;criminal;hunt;lead;run;team;path;killer;associate;search;life;operation;unexpected;work;cryptic;deadly;terrorist;
Black Mirror|woman;narrative;memory;sociable;world;life;experience;medium;run;traveler;dark;death;technology;carry;people;secret;strange;executive;pitiless;time;
Harlots|hazard;keeper;support;retaliation;daughter;life;awful;trap;opportunity;escape;home;family;whorehouse;danger;death;much;woman;repute;introduce;path;
13 Reasons Why|school;tape;mother;party;friend;student;struggle;home;mystery;record;chitchat;plan;night;death;suicide;conflict;battle;tragic;reading;drive;
Almost Human|investigate;murder;crime;blossom;killer;drug;police;death;battle;probe;target;killing;kill;case;dorian;victim;combat;necessitate;past;apprehension;
Utopia|run;secret;gang;mystery;life;uncover;influenza;identity;manuscript;plan;race;alive;disclosure;terrify;departure;group;graphic;coerce;agree;forum;
Broadchurch|case;murder;death;suspect;uncover;evidence;run;town;medium;community;coerce;force;pressure;son;crime;investigate;male_child;local;life;struggle;
The Fall|case;killer;hunt;murder;dramatic;evidence;pressure;coerce;team;manipulative;attacker;deal;attack;search;victim;disclosure;decision;reappraisal;legal;probe;
Riverdale|uncover;tension;plan;secret;support;mother;family;lead;friend;death;mystery;town;confront;father;confrontation;unexpected;run;coerce;meeting;gang;
The OA|home;old_age;life;childhood;dramatic;narrative;family;motion;work;plan;group;dream;child;woman;chink;hatch;resoluteness;point;breakage;later;
Outcast|possession;mystery;family;struggle;power;town;life;unexpected;dangerous;support;friend;devil;force;clasp;uncover;confront;escape;demonic;wife;menace;
Lie to Me|woman;investigate;murder;daughter;case;kill;death;uncover;run;leader;team;charge;witness;operation;girl;probe;lead;trust;play;lie;
The Big Bang Theory|guy;relationship;work;gang;life;date;friend;meet;battle;play;game;girl;party;apartment;mother;dating;plan;comedian;woman;occupation;
Buffy the Vampire Slayer|gang;devil;vampire;enchantment;run;life;friend;battle;power;killing;home;departure;killer;force;uncover;universe;magic;kill;mother;student;
Star Trek|crew;foreigner;planet;ship;brush;universe;race;battle;control;die;force;cryptic;enterprise;run;death;power;strange;destroy;investigate;companion;
House|team;patient;case;life;checkup;hospital;dainty;symptom;treatment;deal;diagnosis;woman;man;relationship;play;diagnose;illness;death;work;struggle;
Stargate Atlantis|team;city;ship;planet;expedition;cast;enemy;lead;control;capture;search;base;earth;mission;destroy;rescue;world;foreigner;universe;run;
Charmed|sister;devil;power;life;enchantment;evil;enchantress;death;cast;killing;time;child;warlock;man;save;baby;charming;protect;bargain;travel;
American Horror Story|uncover;house;life;disturb;family;murder;dangerous;history;past;dark;lead;home;run;search;plan;confront;play;terrify;survive;force;
Heroes|father;life;hero;uncover;family;play;lead;meet;search;travel;past;power;plan;operation;run;man;control;secret;future;time;
Lost|island;survivor;uncover;life;cryptic;camp;hatch;secret;past;plan;jungle;flashback;rescue;air_out;play;meet;search;run;beach;woman;
Prison Break|plan;escape;prison;run;inmate;trouble;life;meet;death;operation;search;brother;uncover;interruption;escapee;lead;force;hazard;company;execute;
Orange Is the New Black|inmate;prison;business;run;support;life;occupation;power;coerce;prisoner;supporter;challenge;deal;crack;disclosure;confront;force;pressure;trouble;home;
Revolution|power;gang;plan;search;lead;struggle;son;life;meet;dangerous;associate;danger;rescue;companion;hazard;endanger;ally;support;survive;relationship;
Person of Interest|team;finch;protect;life;crime;identify;machine;investigate;poi;identity;plan;mission;young;past;government;menace;clandestine;dangerous;organization;stopping_point;
Scorpion|team;save;life;deadly;endanger;mission;nuclear;run;uncover;scorpio;trap;occupation;steal;secret;case;dangerous;play;father;simple;exposure;
Arrow|team;city;killing;battle;father;attack;death;plan;deal;friend;past;life;run;oliver;family;meet;surprise;starling;control;drug;
Once Upon a Time|search;hero;life;flashback;fairytale;plan;town;magic;universe;past;pursuit;save;uncover;land;family;love;dark;power;run;hope;
Grimm|investigate;lead;cryptic;probe;murder;death;deal;case;local;family;homicide;force;battle;meet;support;work;life;search;man;run;
Rectify|life;family;home;question;struggle;death;town;fear;unexpected;seek;surprise;confrontation;die;future;past;confront;run;recover;search;research;
La casa de papel|plan;hostage;police;robber;robbery;history;thief;development;lead;force;carry;home;professor;enroll;recruit;heist;escape;group;execution;power;
Alias|father;life;mother;agent;truth;uncover;mission;secret;lead;search;meet;death;cryptic;recover;path;question;deadly;sent;deal;commitment;
